%%%%%%%%%%%%%%%%%%%%%%%%
%     ..        .....  %
%    ....       .....  %
%   ..  ..       ...   %
%  ... P ..      ... G %
%  .........     ...   %
% ...........   .....  %
%...       ...  ..... o%
%%%%%%%%%%%%%%%%%%%%%%%%
